AALESUND - ASD
AC MILAN - ACM
ADO DEN HAAG - ADH
AJACCIO - AJC
AJAX - AJX
ALBANIA - ALB
ALGERIA - ALG
ALMERIA - AMR
AMERICA - ARA
ANDORRA - AND
ANGERS - ANG
APOEL NICOSIA - ANS
ARBEDEEN - ARB
ARGENTINA - ARG
ARMENIA - ARM
ARSENAL - ARS
ASHINGTON AFC - AFC
ASTON VILLA - AVL
ATALANTA - ATA
ATHLETIC BILBAO - ATB
ATLETICO MADRID - ATM
AUSTRIA - AUS
AUSTRIA WIEN - AWN
AZ ALKAMAR - AZA
AZERBAIJAN - AZJ
BARCELONA - BAR
BARNSLEY - BNY
BASTIA - BST
BAYER LEVERKUSEN - BYL
BAYERN MUNICH - BAY
BELARUS - BLS
BELGIUM - BEL
BENFICA - BFC
BIRMINGHAM CITY - BHC
BLACKBURN ROVERS - BBR
BLACKPOOL - BCP
BOHEMEIANS - BHS
BOLIVIA - BLV
BOLOGNA - BGA
BOLTON - BOL
BORDEAUX - BDX
BORUSSIA DORTMUND FC - BVB
BOSHERZ - BHZ
BOSNIA HERZEGOVINA - BHG
BOURNEMOUTH - BMH
BRAZIL - BRA
BRENTFORD - BFD
BRIGHTON - BGT
BRISTOL ROVERS - BTR
BRISTOL ROVERS - BRS
BROMLEY - BLY
BULGARIA - BLG
BURIKINA FASO - BFA
BURNLEY - BUR
BURY - BRY
CAEN - CEN
CAGLIARI - CAG
CAMBUUR - CBR
CAMEROON - CMR
CAPE VERDE ISLANDS - CPV
CELTA DE VIGO - CDV
CELTIC F.C. - CFC
CESNA - CSA
CHELSEA - CHE
CHICAGO FIRE - CGF
CHIEVO - CHV
CHILE - CLE
CLUB BRUGGE - CBG
COLCHESTER - CHR
COLLORADO RAPIDS - CDR
COLUMBIA - CLB
COLUMBUS CREW - CBC
CONGO - COG
CONGO DRC - COD
CORDOBA - CDB
COSTA RICA - CRA
COTE DIVOIRE - CDI
CREWE ALEXANDRA - CWA
CROATIA - CRO
CRYSTAL PALACE - CRY
CSK MOSCOW - CSK
CYPRUS - CYP
CZECH REPUBLIC - CZH
D.C. UNITED - DCU
DE GRAAFSCHAP - DGP
DENMARK - DEN
DEPORTIVO LA CORUNA - DLC
DERBY COUNTY - DBC
DONCASTER ROVERS - DCR
DUNDEE UNITED - DUD
DYNAMO ZAGBREB - DZB
ECUADOR - EDR
EIBAR - EBR
EINTRACHT FRANKFURT - ETF
ELCHE - ECE
EMPOLI - EMP
ENGLAND - ENG
EQUITORIAL GUINEA - EQG
ESPANYOL - ESP
ESTONIA - EST
EVAN THONON GAILLARD - ETG
EVERTON - EVE
F.C BASEL  - BAS
F.C TWENTE - FCT
F.C. DALLAS - FCD
F.C. PORTO - FCP
F.K ASTANA - FKA
FAROE ISLANDS - FIS
FC AUGSBURG - FAG
FC BATE BORISOV - FBB
FC BATE BORISOV - BBV
FC FREIGURG - FCF
FC GRONIGEN - FCG
FC KOLHN - FCK
FC UTRECHT - UTR
FERBANACHE - FBC
FINLAND - FIN
FIORENTINA - FIO
FLEETWOOD TOWN - FLT
FRANCE - FRA
GABON - GAB
GALATASARAY - GTY
GATESHED - GTD
GENOA - GEN
GEORGIA - GGA
GERMANY - GER
GETAFE - GTE
GHANA - GHA
GIBRALTA - GBT
GILLINGHAM - GHM
GRANADA - GNA
GREECE - GRC
GUINEA - GIN
GUINGAMP - GGP
HAMBURGER SV - HMV
HAMILTON - HAM
HANNOVER 96 - HNR
HEARTS - HTS
HELLAS VERONA - HVN
HERACLES ALMELO - HCA
HERTHA BERLIN - HBE
HERTHA BSC - HTB
HIBERNIAN - HBN
HOFFENHEIM - HFM
HOUSTON DYNAMO - HDY
HULL CITY - HUL
HUNGARY - HUN
ICELAND - ICE
INTER MILAN - IML
INVERNESS CT - IVC
IPSWICH TOWN - IWT
IRELAND - IRL
ISRAEL - ISL
ITALY - ITA
JABLONEC - JAB
JUVENTUS - JUV
KAA GENT - KGT
KILMARNOCK FC - KFC
LA GALAXY - LAG
LAS PALMAS - LPS
LATVIA - LAT
LAZIO - LAZ
LEEDS UNITED - LEU
LEICESTER CITY - LEI
LENS - LNS
LEVANTE - LVT
LIECTCTENSTEIN - LCH
LILLE - LLE
LILLESTROM - LLM
LITHUANIA - LIT
LIVERPOOL - LIV
LOKEREN - LKN
LORIENT - LRT
LUGANO F.C. - LGO
LUXEMBOURG - LUX
LYON - LYN
M. TEL AVIV - MTA
MACEDONIA - MAC
MAINZ 05 - MNZ
MALAGA - MLG
MALI - MLI
MALMO FF - MFF
MALTA - MAL
MANCHESTER CITY - MCI
MANCHESTER UNITED - MUN
MARITIMO - MTM
MARSEILLE - MSE
METZ - MTZ
MEXICO - MEX
MIDDLESBROUGH - MLB
MIDTYLLAND - MLD
MILLWALL - MWL
MILSAMI - MSI
MJENDALEN - MJN
MK DONS - MKD
MOLDOVA - MOL
MONACO - MNC
MONTENEGRO - MNG
MONTPELLIER - MPL
MONTREAL IMPACT - MNI
MORDOVIA SARANSK - MSK
MOTHERWELL FC - MFC
MUNCHENGLADBACH - MGH
N.E.C - NEC
NANTES - NTS
NAPOLI - NAP
NE REVOLUTION - NER
NEC NIMAJEN - NCN
NETHERLANDS - NED
NEW CASTLE UNITED - NEW
NEW YORK CITY FC - NYC
NICE - NCE
NIGER - NGR
NIGERIAN - NGN
NORWAY - NWY
NORWICH CITY - NWC
NOTHERN IRELAND - NIR
NY REDBULLS - NRB
ODD - ODD
OLDHAM ATLHETIC - OAT
OLYMPIAKOS - OLY
ORLANDO CITY SC - OCS
ORLANDO CITY SC - OCS
OXFORD UNITED - OXU
PALERMO - PAL
PANATHINAIKOS - PTS
PANDERBORN - PDB
PARAGUAY - PGY
PARIS SAINT GERMAIN - PSG
PARMA - PAR
PEC ZWOLLE - PZW
PERU - PRU
PHILADELPHIA - PHI
POLAND - POL
PORT VALE - PTV
PORTLAND TIMBERS - PLT
PORTUGAL - PGL
PRESTON NORTH - PNN
PSV EINHOVEN - PSV
QUEENS PARK RANGERS - QPR
RAPID VIENNA - RVN
RAYO VALLECANO - RVC
READING - REA
REAL BERTIS - RBT
REAL MADRID - RMD
REAL SALT LAKE - RSL
REAL SOCIEDAD - RSD
REIMS - RMS
RENNES - RNS
RHEINDORF ALTACH - RAH
RIO AVE - RAV
RKC WAALWIJK - RKC
ROCHDALE - RDL
RODA JC KERKRADE - RJC
ROMA - RMA
ROSENBORG - RNG
ROTHERHAM UNITED - RTU
RUSSIA - RUS
S. KORCE - SKE
SAINT ETIENNE - SET
SALZBURG - SZB
SAMPDORIA - SDR
SAN MARONI - SAN
SANDERFIORD - SDD
SASSUOLO - SSO
SBV EXCELSIOR - SBV
SC CAMBUUR - SCC
SC HEERENVEEN - SCH
SCOTLAND - SCL
SCUNTHORPE - SCP
SEATLE - STL
SENEGAL - SEN
SERBIA - SEB
SEVILLA - SVL
SHAKTAR DONETSK - SDK
SHALKE - SHK
SHREWBURY TOWN - SHT
SJ EARTHQUAKES - SJE
SLOVENIA - SLV
SOUTH AFRICA - ZAF
SOUTHAMPTON - SOU
SPAIN - SPA
SPARTA PRAGUE - SPG
SPARTA ROTTERDAM - SPR
SPORTING CHALEROI - SCI
SPORTING KC - SKC
ST. JOHNSTONE F.C. - SJF
START - STT
STOKE CITY - STO
SUNDERLAND - SUN
SWANSEA CITY - SWA
SWEDEN - SWE
SWINDON TOWN - SWT
SWITZERLAND - SWI
Tipping 1.35 Draw 1.38 - TIP
TORINO - TOR
TORONTO FC - TFC
TOTTENHAM HOTSPUR - TOT
TOULOUSE - TLE
TROYES - TRS
TUNISIA - TUN
TURKEY - TUR
UDINESE - UDI
UGANDA - UGN
UKRAINE - UKR
URAL - URL
URUGUAY - UGY
VADUZ F.C. - VDZ
VALENCIA - VAL
VANCOUVER - VCR
VERONA - VER
VFB STUTTGART - VFS
VIKTORIA PLZEN - VPZ
VILLARREAL - VIL
VITESSE - VIT
WALES - WLS
WALSALL - WSL
WATFORD - WAT
WATFORD - WFD
WERDER BREMEN - WBR
WEST BROM - WBA
WEST HAM UNITED - WHU
WIGAN ATHLETIC - WIG
WILLEM II - WLM
WOLFSBURG - WFB
WOLVERHAMPTON - WOL
YOUNG BOYS - YBS
ZAMBIA - ZAM
ZENITH ST PETERSBURG - ZEN
ZIMBABWE  - ZIM
